000wwwww0w00www
0w00000w0ww0w00
00ww0w000w0000w
w000wwww000w0ww
000w00000www00w
ww0wwww0ww000ww
000www0000w0www
0w000ww0www00ww
0ww0w000w000www
www00www00wwwww
www0ww0000ww00w
w000w00w0ww00ww
00w000w00000www
wwww00ww0w00www
w0000www00w000a
